sea	海[うみ]	chapter05
postal stamps	切[きっ] 手[て]	chapter05
ticket	切[きっ] 符[ぷ]	chapter05
surfing	サーフィン	chapter05
homework	宿[しゅく] 題[だい]	chapter05
food	食[た]べ 物[もの]	chapter05
birthday	誕生[たんじょう] 日[び]	chapter05
test	テスト	chapter05
weather	天[てん] 気[き]	chapter05
drink	飲[の] み物[もの]	chapter05
postcard	葉[は] 書[がき]	chapter05
bus	バス	chapter05
airplane	飛[ひ] 行[こう] 機[き]	chapter05
room	部屋[へや]	chapter05
I (used by men)	僕[ぼく]	chapter05
holiday; day off; absence	休[やす] み	chapter05
travel	旅[りょ] 行[こう]	chapter05
new	新[あたら]しい	chapter05
hot (weather)	暑[あつ]い	chapter05
hot (thing)	熱[あつ]い	chapter05
busy (people/days)	忙[いそが]しい	chapter05
large	大[おお]きい	chapter05
interesting; funny	面[おも] 白[しろ]い	chapter05
good-looking (conjugates like いい)	かっこいい	chapter05
frightening	怖[こわ]い	chapter05
cold (weather--not used for things)	寒[さむ]い	chapter05
fun	楽[たの]しい	chapter05
small	小[ちい]さい	chapter05
boring	つまらない	chapter05
old (thing--not used for people)	古[ふる]い	chapter05
difficult	難[むずか]しい	chapter05
easy (problem); kind (person)	やさしい	chapter05
inexpensive; cheap (thing)	安[やす]い	chapter05
disgusted with; to dislike (〜が)	嫌[さら]い(な)	chapter05
beautiful; clean	きれい(な)	chapter05
healthy; energetic	元[げん] 気[き](な)	chapter05
quiet	静[しず]か(な)	chapter05
fond of; to like (〜が)	好[す]き(な)	chapter05
to hate (〜が)	大[だい] 嫌[きら]い(な)	chapter05
very fond of; to love (〜が)	大[だい] 好[す]き(な)	chapter05
lively	にぎやか(な)	chapter05
not busy; to have a lot of free time	暇[ひま] (な)	chapter05
to swim	泳[およ]ぐ	chapter05
to ask (person に)	聞[き]く	chapter05
to ride; to board (〜に)	乗[の]る	chapter05
to do; to perform (〜を)	やる	chapter05
to go out	出[で]かける	chapter05
together	一[いっ] 緒[しょ]に	chapter05
extremely	すごく	chapter05
and then	それから	chapter05
It's okay.; Not to worry.; Everything is under control.	大[だい] 丈[じょう] 夫[ぶ]	chapter05
very	とても	chapter05
what kind of...	どんな	chapter05
[counter for flat objects]	〜まい	chapter05
to (a place); as far as (a place); till (a time)	〜まで	chapter05
money	お金[かね]	chapter06
bath	お 風[ふ] 呂[ろ]	chapter06
kanji; Chinese character	漢[かん] 字[じ]	chapter06
textbook	教[きょ] 科[か] 書[しょ]	chapter06
this week	今[こん] 週[しゅう]	chapter06
CD	CD（シーディー）	chapter06
municipal hospital	市[し] 民[みん] 病[びょう] 院[いん]	chapter06
shower	シャワー	chapter06
next	次	chapter06
electricity	電[でん] 気[き]	chapter06
train	電[でん] 車[しゃ]	chapter06
baggage	荷[に] 物[もつ]	chapter06
personal computer	パソコン	chapter06
page	パージ	chapter06
window	窓[まど]	chapter06
night	夜[よる]	chapter06
next week	来[らい] 週[しゅう]	chapter06
next year	来[らい] 年[ねん]	chapter06
tough (situation)	大[たい] 変[へん] (な)	chapter06
to play; to spend time pleasantly	遊[あそ]ぶ	chapter06
to hurry	急[いそ]ぐ	chapter06
to take a bath	お 風[ふ] 呂[ろ]に 入[はい]る	chapter06
to return (a thing) (person に thing を)	返[かえ]す	chapter06
to turn off; to erase (〜を)	消[け]す	chapter06
to die	死[し]ぬ	chapter06
to sit down (seat に)	座[すわ]る	chapter06
to stand up	立[た]つ	chapter06
to smoke	たばこを 吸[す]う	chapter06
to use (〜を)	使[つか]う	chapter06
to help (person/task を)	手[て] 伝[つだ]う	chapter06
to enter (〜に)	入[はい]る	chapter06
to carry; to hold (〜を)	持[も]つ	chapter06
"(1) to be absent (from...) (〜を)
(2) to rest"	休[やす]む	chapter06
to open (something) (〜を)	開[あ]ける	chapter06
to teach; to instruct (person に thing を)	教[おし]える	chapter06
to get off (〜を)	降[お]りる	chapter06
to borrow (person に thing を)	借[か]りる	chapter06
to close (something) (〜を)	閉[し]める	chapter06
to take a shower	シャワーを 浴[あ]びる	chapter06
to turn on (〜を)	つける	chapter06
to make a phone call (〜に)	電[でん] 話[わ]をかける	chapter06
to forget; to leave behind (〜を)	忘[わす]れる	chapter06
to bring (a person) (〜を)	連[つ]れてくる	chapter06
to bring (a thing) (〜を)	持[も]ってくる	chapter06
later on	後[あと]で	chapter06
(do something) late	遅[おそ]く	chapter06
because...	〜から	chapter06
That would be fine.; That wouldn't be necessary.	結[けっ] 構[こう]です	chapter06
right away	すぐ	chapter06
Really?	本[本] 当[とう]ですか	chapter06
slowly; leisurely; unhurriedly	ゆっくり	chapter06
